{

	"debug": [
		[ 0, 0, 0, 0, 1, 0, 0, 0, 0 ],
		[ 0, 0, 0, 0, 0, 0, 0, 0, 0 ],
		[ 0, 0, 0, 0, 0, 0, 0, 0, 0 ],
		[ 0, 0, 0, 0, 0, 0, 0, 0, 0 ],
		[ 0, 2, 0, 0, 1, 1, 0, 0, 0 ],
		[ 0, 0, 0, 0, 0, 0, 0, 0, 0 ],
		[ 0, 0, 0, 0, 0, 0, 0, 0, 0 ],
		[ 0, 0, 0, 0, 0, 0, 0, 0, 0 ],
		[ 0, 0, 0, 0, 3, 0, 0, 0, 0 ]
	],

	"stage1": [

		[ 0, 0, 0, 0, 1, 0, 0, 0, 0 ],
		[ 0, 0, 0, 0, 0, 0, 0, 0, 0 ],
		[ 0, 0, 0, 1, 1, 1, 0, 0, 0 ],
		[ 0, 0, 0, 0, 0, 0, 0, 0, 0 ],
		[ 0, 0, 1, 1, 1, 1, 1, 0, 0 ],
		[ 0, 0, 0, 0, 0, 0, 0, 0, 0 ],
		[ 0, 1, 1, 1, 1, 1, 1, 1, 0 ],
		[ 0, 0, 0, 0, 0, 0, 0, 0, 0 ],
		[ 0, 0, 0, 1, 1, 1, 0, 0, 0 ],
		[ 0, 0, 0, 0, 0, 0, 0, 0, 0 ],
		[ 0, 0, 0, 0, 0, 0, 0, 0, 0 ],
		[ 0, 0, 0, 0, 0, 0, 0, 2, 0 ],
		[ 0, 0, 0, 0, 0, 0, 0, 0, 0 ],
		[ 0, 0, 0, 0, 0, 0, 0, 0, 0 ],
		[ 0, 0, 0, 0, 0, 0, 1, 1, 1 ],
		[ 0, 0, 0, 0, 0, 0, 1, 1, 1 ],
		[ 0, 0, 0, 0, 0, 0, 0, 0, 0 ],
		[ 0, 0, 0, 0, 0, 0, 0, 0, 0 ],
		[ 0, 0, 0, 1, 1, 1, 0, 0, 0 ],
		[ 0, 0, 0, 1, 1, 1, 0, 0, 0 ],
		[ 0, 0, 0, 0, 0, 0, 0, 0, 0 ],
		[ 0, 0, 0, 0, 0, 0, 0, 0, 0 ],
		[ 0, 0, 0, 0, 1, 0, 0, 0, 0 ],
		[ 0, 0, 0, 0, 1, 0, 0, 0, 0 ],
		[ 0, 0, 0, 1, 1, 1, 0, 0, 0 ],
		[ 0, 0, 0, 0, 1, 0, 0, 0, 0 ],
		[ 0, 0, 0, 1, 1, 1, 0, 0, 0 ],
		[ 0, 0, 0, 0, 1, 0, 0, 0, 0 ],
		[ 0, 0, 0, 1, 1, 1, 0, 0, 0 ],
		[ 0, 0, 0, 0, 1, 0, 0, 0, 0 ],
		[ 0, 0, 0, 0, 1, 0, 0, 0, 0 ],
		[ 0, 0, 0, 0, 1, 0, 0, 0, 0 ],
		[ 0, 0, 0, 0, 1, 0, 0, 0, 0 ],
		[ 0, 0, 0, 0, 1, 0, 0, 0, 0 ],
		[ 1, 1, 1, 1, 1, 1, 1, 1, 1 ],
		[ 1, 1, 1, 1, 1, 1, 1, 1, 1 ],
		[ 0, 0, 0, 0, 0, 0, 0, 0, 0 ],
		[ 0, 0, 0, 0, 0, 0, 0, 0, 0 ],
		[ 0, 0, 0, 0, 0, 0, 0, 0, 0 ],
		[ 0, 0, 0, 0, 1, 0, 0, 0, 0 ],
		[ 0, 0, 0, 1, 0, 1, 0, 0, 0 ],
		[ 0, 0, 0, 1, 0, 1, 0, 0, 0 ],
		[ 0, 0, 0, 1, 0, 1, 0, 0, 0 ],
		[ 0, 0, 0, 0, 1, 0, 0, 0, 0 ],
		[ 0, 0, 0, 0, 0, 0, 0, 0, 0 ],
		[ 0, 0, 0, 0, 0, 0, 0, 0, 0 ],
		[ 0, 0, 0, 0, 0, 0, 0, 0, 0 ],
		[ 0, 0, 0, 0, 0, 0, 0, 0, 0 ],
		[ 0, 0, 0, 0, 1, 0, 0, 0, 0 ],
		[ 0, 0, 0, 1, 0, 1, 0, 0, 0 ],
		[ 0, 0, 1, 0, 0, 0, 1, 0, 0 ],
		[ 1, 1, 0, 0, 0, 0, 0, 1, 1 ],
		[ 1, 1, 0, 0, 2, 0, 0, 1, 1 ],
		[ 1, 1, 0, 0, 0, 0, 0, 1, 1 ],
		[ 1, 1, 0, 0, 0, 0, 0, 1, 1 ],
		[ 0, 1, 1, 0, 0, 0, 1, 1, 0 ],
		[ 0, 0, 0, 1, 0, 1, 0, 0, 0 ],
		[ 0, 0, 0, 0, 1, 0, 0, 0, 0 ],
		[ 0, 0, 0, 0, 0, 0, 0, 0, 0 ],
		[ 0, 0, 0, 0, 0, 0, 0, 0, 0 ],
		[ 0, 0, 0, 0, 0, 0, 0, 0, 0 ],
		[ 0, 0, 0, 0, 0, 0, 0, 0, 0 ],
		[ 0, 0, 0, 0, 0, 0, 0, 0, 0 ],
		[ 0, 0, 1, 1, 1, 1, 1, 0, 0 ],
		[ 0, 0, 1, 0, 1, 0, 1, 0, 0 ],
		[ 0, 0, 1, 0, 1, 1, 1, 0, 0 ],
		[ 0, 0, 1, 0, 1, 0, 1, 0, 0 ],
		[ 0, 0, 1, 1, 1, 1, 1, 0, 0 ],
		[ 0, 0, 1, 0, 1, 0, 1, 0, 0 ],
		[ 0, 0, 1, 1, 1, 1, 1, 0, 0 ],
		[ 0, 0, 1, 0, 1, 0, 1, 0, 0 ],
		[ 0, 0, 1, 1, 1, 1, 1, 0, 0 ],
		[ 0, 0, 1, 1, 1, 1, 1, 0, 0 ],
		[ 0, 0, 0, 0, 1, 0, 0, 0, 0 ],
		[ 0, 0, 0, 0, 1, 0, 0, 0, 0 ],
		[ 0, 2, 0, 0, 1, 0, 0, 2, 0 ],
		[ 0, 0, 0, 0, 1, 0, 0, 0, 0 ],
		[ 0, 0, 0, 0, 1, 0, 0, 0, 0 ],
		[ 1, 1, 1, 1, 1, 1, 1, 1, 1 ],
		[ 0, 0, 1, 1, 1, 1, 1, 0, 0 ]

	],

	"stage2": [

		[ 0, 0, 0, 0, 0, 0, 0, 1, 1 ],
		[ 0, 0, 2, 0, 0, 0, 1, 1, 0 ],
		[ 0, 0, 0, 0, 0, 1, 1, 0, 0 ],
		[ 0, 0, 0, 0, 1, 1, 0, 0, 0 ],
		[ 0, 0, 0, 1, 1, 0, 0, 0, 0 ],
		[ 0, 0, 1, 1, 0, 0, 0, 0, 0 ],
		[ 0, 1, 1, 0, 0, 0, 0, 0, 0 ],
		[ 1, 1, 0, 0, 0, 0, 2, 0, 0 ],
		[ 0, 1, 1, 0, 0, 0, 0, 0, 0 ],
		[ 0, 0, 0, 0, 0, 0, 0, 0, 0 ],
		[ 0, 0, 0, 0, 1, 0, 0, 0, 0 ],
		[ 0, 0, 0, 0, 1, 0, 0, 0, 0 ],
		[ 0, 0, 0, 0, 1, 0, 0, 2, 0 ],
		[ 0, 0, 0, 0, 1, 0, 0, 0, 0 ],
		[ 0, 0, 0, 1, 1, 1, 0, 0, 0 ],
		[ 0, 1, 1, 1, 1, 1, 1, 1, 0 ],
		[ 0, 0, 0, 1, 1, 1, 0, 0, 0 ],
		[ 0, 0, 0, 0, 1, 0, 0, 0, 0 ],
		[ 0, 2, 0, 0, 1, 0, 0, 0, 0 ],
		[ 0, 0, 0, 0, 1, 0, 0, 0, 0 ],
		[ 0, 0, 0, 0, 1, 0, 0, 0, 0 ],
		[ 0, 1, 1, 1, 1, 1, 1, 1, 0 ],
		[ 0, 0, 0, 0, 1, 1, 0, 0, 0 ],
		[ 0, 0, 0, 0, 0, 1, 1, 0, 0 ],
		[ 0, 0, 0, 0, 0, 0, 1, 1, 0 ],
		[ 0, 0, 0, 0, 0, 0, 0, 1, 1 ],
		[ 0, 0, 0, 0, 0, 0, 0, 1, 1 ],
		[ 0, 0, 0, 0, 0, 0, 1, 1, 0 ],
		[ 0, 0, 0, 0, 0, 1, 1, 0, 0 ],
		[ 0, 0, 0, 0, 1, 1, 0, 0, 0 ],
		[ 0, 0, 0, 1, 1, 0, 0, 0, 0 ],
		[ 0, 0, 1, 1, 0, 0, 0, 0, 0 ],
		[ 0, 1, 1, 0, 0, 0, 0, 0, 0 ],
		[ 1, 1, 0, 0, 0, 1, 1, 0, 0 ],
		[ 1, 1, 0, 0, 0, 0, 1, 1, 0 ],
		[ 1, 0, 0, 0, 0, 0, 0, 1, 1 ],
		[ 1, 1, 0, 0, 2, 0, 0, 1, 1 ],
		[ 1, 0, 0, 0, 0, 0, 0, 1, 1 ],
		[ 1, 1, 0, 0, 0, 0, 0, 1, 1 ],
		[ 1, 1, 1, 0, 0, 0, 0, 1, 1 ],
		[ 0, 1, 1, 1, 0, 0, 1, 1, 1 ],
		[ 0, 0, 1, 1, 1, 1, 1, 0, 0 ],
		[ 0, 0, 0, 1, 1, 1, 0, 0, 0 ],
		[ 0, 0, 0, 0, 0, 0, 0, 0, 0 ],
		[ 0, 0, 0, 0, 0, 0, 0, 0, 0 ],
		[ 0, 0, 0, 0, 0, 0, 0, 0, 0 ],
		[ 0, 0, 0, 0, 0, 0, 0, 0, 0 ],
		[ 0, 0, 0, 1, 1, 1, 0, 0, 0 ],
		[ 0, 0, 1, 1, 0, 1, 1, 0, 0 ],
		[ 0, 1, 1, 0, 0, 0, 1, 1, 0 ],
		[ 1, 1, 0, 0, 0, 0, 0, 1, 1 ],
		[ 1, 1, 0, 1, 1, 1, 0, 1, 1 ],
		[ 1, 1, 0, 0, 1, 0, 0, 1, 1 ],
		[ 1, 1, 0, 1, 1, 1, 0, 1, 1 ],
		[ 1, 1, 0, 0, 0, 0, 0, 1, 1 ],
		[ 1, 1, 0, 0, 0, 0, 0, 1, 1 ],
		[ 1, 1, 0, 0, 2, 0, 0, 1, 1 ],
		[ 1, 1, 0, 0, 0, 0, 0, 1, 1 ],
		[ 1, 1, 0, 0, 0, 0, 0, 1, 1 ],
		[ 1, 1, 1, 1, 1, 1, 1, 1, 1 ],
		[ 1, 1, 0, 0, 0, 0, 0, 1, 1 ],
		[ 1, 1, 0, 0, 0, 0, 0, 1, 1 ],
		[ 1, 1, 0, 0, 2, 0, 0, 1, 1 ],
		[ 1, 1, 0, 0, 0, 0, 0, 1, 1 ],
		[ 0, 1, 1, 0, 0, 0, 1, 1, 0 ],
		[ 0, 1, 1, 1, 0, 1, 1, 1, 0 ],
		[ 0, 1, 0, 1, 1, 1, 0, 1, 0 ],
		[ 0, 1, 0, 0, 1, 0, 0, 1, 0 ],
		[ 0, 1, 0, 0, 1, 0, 0, 1, 0 ],
		[ 0, 1, 0, 0, 1, 0, 0, 1, 0 ],
		[ 0, 1, 3, 0, 1, 0, 3, 1, 0 ],
		[ 0, 1, 0, 0, 1, 0, 0, 1, 0 ],
		[ 0, 1, 0, 0, 0, 0, 0, 1, 0 ],
		[ 0, 1, 0, 0, 0, 0, 0, 1, 0 ],
		[ 0, 1, 0, 0, 2, 0, 0, 1, 0 ],
		[ 0, 1, 0, 0, 0, 0, 0, 1, 0 ],
		[ 0, 1, 0, 0, 0, 0, 0, 1, 0 ],
		[ 0, 1, 3, 0, 3, 0, 3, 1, 0 ],
		[ 0, 1, 1, 1, 1, 1, 1, 1, 0 ],
		[ 0, 1, 1, 1, 1, 1, 1, 1, 0 ]

	],

	"stage3": [

		[ 1, 1, 0, 0, 0, 0, 0, 0, 0 ],
		[ 1, 1, 0, 0, 0, 0, 0, 0, 0 ],
		[ 1, 1, 0, 0, 0, 0, 0, 0, 0 ],
		[ 0, 1, 1, 0, 0, 3, 0, 3, 0 ],
		[ 0, 0, 1, 1, 0, 0, 0, 0, 0 ],
		[ 0, 0, 0, 1, 1, 0, 0, 0, 0 ],
		[ 0, 0, 0, 0, 1, 1, 0, 0, 0 ],
		[ 0, 0, 0, 0, 0, 1, 1, 0, 0 ],
		[ 0, 0, 0, 0, 0, 0, 1, 1, 0 ],
		[ 0, 0, 0, 0, 0, 0, 0, 1, 1 ],
		[ 0, 0, 0, 0, 0, 0, 0, 1, 1 ],
		[ 0, 0, 0, 0, 0, 0, 0, 1, 1 ],
		[ 0, 3, 0, 3, 0, 3, 1, 1, 0 ],
		[ 0, 0, 0, 0, 0, 1, 1, 0, 0 ],
		[ 0, 0, 0, 0, 1, 1, 0, 0, 0 ],
		[ 0, 0, 0, 1, 1, 0, 0, 0, 0 ],
		[ 0, 0, 1, 1, 0, 0, 0, 0, 0 ],
		[ 0, 1, 1, 0, 0, 0, 0, 0, 0 ],
		[ 1, 1, 0, 0, 0, 0, 2, 0, 0 ],
		[ 1, 1, 0, 0, 0, 0, 0, 0, 0 ],
		[ 1, 1, 0, 0, 0, 0, 0, 0, 0 ],
		[ 0, 1, 1, 0, 0, 3, 0, 3, 0 ],
		[ 0, 0, 1, 1, 0, 0, 0, 0, 0 ],
		[ 0, 0, 0, 1, 1, 0, 0, 0, 0 ],
		[ 0, 0, 0, 0, 1, 1, 0, 0, 0 ],
		[ 0, 0, 0, 0, 0, 1, 1, 0, 0 ],
		[ 0, 0, 0, 0, 0, 0, 1, 1, 1 ],
		[ 0, 0, 0, 0, 0, 0, 0, 1, 1 ],
		[ 0, 0, 0, 0, 2, 0, 0, 1, 1 ],
		[ 0, 0, 0, 0, 0, 0, 0, 1, 1 ],
		[ 0, 3, 0, 3, 0, 3, 1, 1, 1 ],
		[ 0, 0, 0, 0, 0, 1, 1, 0, 0 ],
		[ 0, 0, 0, 0, 1, 1, 0, 0, 0 ],
		[ 0, 0, 0, 1, 1, 0, 0, 0, 0 ],
		[ 0, 0, 1, 1, 0, 0, 0, 0, 0 ],
		[ 1, 1, 1, 0, 0, 0, 0, 0, 0 ],
		[ 1, 1, 0, 0, 0, 0, 0, 0, 0 ],
		[ 1, 1, 0, 3, 0, 0, 0, 3, 0 ],
		[ 1, 1, 0, 0, 0, 0, 0, 0, 0 ],
		[ 1, 1, 1, 0, 0, 0, 0, 0, 0 ],
		[ 0, 1, 1, 1, 0, 0, 0, 0, 0 ],
		[ 0, 0, 1, 1, 1, 0, 0, 0, 0 ],
		[ 0, 0, 0, 1, 1, 1, 0, 0, 0 ],
		[ 0, 0, 0, 0, 1, 1, 1, 0, 0 ],
		[ 0, 0, 0, 0, 0, 1, 1, 1, 0 ],
		[ 0, 0, 0, 2, 0, 0, 1, 1, 1 ],
		[ 0, 3, 0, 0, 0, 3, 0, 1, 1 ],
		[ 0, 0, 0, 0, 0, 0, 1, 1, 1 ],
		[ 0, 0, 0, 0, 0, 1, 1, 1, 0 ],
		[ 0, 0, 0, 0, 1, 1, 1, 0, 0 ],
		[ 0, 0, 0, 1, 1, 1, 0, 0, 0 ],
		[ 0, 0, 1, 1, 1, 0, 0, 0, 0 ],
		[ 0, 1, 1, 1, 0, 0, 2, 0, 0 ],
		[ 1, 1, 1, 0, 0, 0, 0, 0, 0 ],
		[ 1, 1, 0, 3, 0, 3, 0, 3, 0 ],
		[ 1, 1, 1, 0, 0, 0, 0, 0, 0 ],
		[ 0, 1, 1, 1, 0, 0, 0, 0, 0 ],
		[ 0, 0, 1, 1, 1, 0, 0, 0, 0 ],
		[ 0, 0, 0, 1, 1, 1, 0, 0, 0 ],
		[ 0, 0, 0, 0, 1, 1, 1, 0, 0 ],
		[ 0, 0, 0, 0, 0, 1, 1, 1, 0 ],
		[ 0, 0, 0, 0, 0, 0, 1, 1, 0 ],
		[ 0, 0, 0, 0, 0, 0, 0, 1, 0 ],
		[ 0, 0, 1, 1, 1, 1, 1, 1, 1 ],
		[ 0, 0, 1, 1, 1, 1, 1, 1, 1 ],
		[ 0, 0, 1, 1, 0, 0, 0, 1, 0 ],
		[ 0, 0, 1, 1, 0, 0, 0, 1, 0 ],
		[ 0, 0, 1, 1, 0, 0, 2, 1, 0 ],
		[ 0, 3, 1, 1, 0, 0, 0, 1, 0 ],
		[ 0, 0, 1, 1, 0, 0, 0, 1, 0 ],
		[ 0, 1, 1, 1, 0, 0, 0, 1, 0 ],
		[ 0, 0, 1, 1, 0, 0, 2, 1, 0 ],
		[ 0, 3, 1, 1, 0, 0, 0, 1, 0 ],
		[ 0, 0, 1, 1, 0, 0, 0, 1, 0 ],
		[ 1, 1, 1, 1, 1, 1, 1, 1, 1 ],
		[ 1, 1, 1, 1, 1, 1, 1, 1, 1 ],
		[ 0, 0, 0, 0, 0, 0, 0, 0, 0 ],
		[ 0, 0, 1, 0, 2, 0, 1, 0, 0 ],
		[ 0, 0, 0, 0, 0, 0, 0, 0, 0 ],
		[ 0, 3, 0, 3, 0, 3, 0, 3, 0 ]

	],

	"stage4": [

		[ 0, 0, 0, 0, 3, 0, 0, 0, 0 ],
		[ 0, 0, 0, 0, 0, 0, 0, 0, 0 ],
		[ 0, 0, 0, 0, 0, 0, 0, 0, 0 ],
		[ 1, 1, 1, 1, 1, 1, 1, 1, 1 ],
		[ 1, 1, 1, 1, 1, 1, 1, 1, 1 ],
		[ 0, 0, 0, 0, 0, 0, 0, 0, 0 ],
		[ 0, 0, 0, 0, 0, 0, 0, 0, 0 ],
		[ 0, 0, 3, 0, 3, 0, 3, 0, 0 ],
		[ 0, 0, 0, 0, 0, 0, 0, 0, 0 ],
		[ 0, 0, 0, 0, 0, 0, 0, 0, 0 ],
		[ 1, 1, 1, 1, 1, 1, 1, 1, 1 ],
		[ 1, 1, 1, 1, 1, 1, 1, 1, 1 ],
		[ 0, 0, 0, 0, 0, 0, 0, 0, 0 ],
		[ 0, 0, 0, 0, 0, 0, 0, 0, 0 ],
		[ 0, 0, 0, 0, 3, 0, 0, 0, 0 ],
		[ 0, 3, 0, 3, 0, 3, 0, 3, 0 ],
		[ 0, 0, 0, 0, 0, 0, 0, 0, 0 ],
		[ 0, 0, 0, 0, 0, 0, 0, 0, 0 ],
		[ 1, 1, 1, 1, 1, 1, 1, 1, 1 ],
		[ 1, 1, 1, 1, 1, 1, 1, 1, 1 ],
		[ 0, 0, 0, 0, 0, 0, 0, 0, 0 ],
		[ 0, 0, 0, 0, 0, 0, 0, 0, 0 ],
		[ 0, 0, 0, 0, 2, 0, 0, 0, 0 ],
		[ 0, 0, 0, 0, 0, 0, 0, 0, 0 ],
		[ 0, 3, 3, 0, 0, 0, 3, 3, 0 ],
		[ 0, 0, 0, 0, 0, 0, 0, 0, 0 ],
		[ 0, 0, 0, 0, 0, 0, 0, 0, 0 ],
		[ 1, 1, 1, 1, 1, 1, 1, 1, 1 ],
		[ 1, 1, 1, 1, 1, 1, 1, 1, 1 ],
		[ 0, 0, 0, 0, 1, 0, 0, 0, 0 ],
		[ 0, 1, 3, 1, 1, 1, 3, 1, 0 ],
		[ 0, 1, 0, 0, 0, 0, 0, 1, 0 ],
		[ 0, 1, 0, 0, 0, 0, 0, 1, 0 ],
		[ 0, 1, 1, 3, 1, 3, 1, 1, 0 ],
		[ 3, 1, 0, 0, 0, 0, 0, 1, 3 ],
		[ 0, 1, 0, 0, 0, 0, 0, 1, 0 ],
		[ 0, 1, 1, 1, 1, 1, 1, 1, 0 ],
		[ 1, 1, 1, 1, 1, 1, 1, 1, 1 ],
		[ 0, 0, 0, 0, 0, 0, 0, 0, 0 ],
		[ 0, 0, 0, 0, 0, 0, 0, 0, 0 ],
		[ 0, 0, 0, 0, 2, 0, 0, 0, 0 ],
		[ 3, 3, 0, 0, 0, 0, 0, 3, 3 ],
		[ 1, 1, 1, 1, 1, 1, 1, 1, 1 ],
		[ 1, 1, 1, 1, 1, 1, 1, 1, 1 ],
		[ 1, 1, 1, 1, 1, 1, 1, 1, 1 ],
		[ 1, 1, 0, 0, 0, 0, 0, 1, 1 ],
		[ 1, 1, 0, 0, 0, 0, 0, 1, 1 ],
		[ 1, 1, 0, 0, 2, 0, 0, 1, 1 ],
		[ 1, 1, 0, 0, 0, 0, 0, 1, 1 ],
		[ 1, 1, 1, 0, 0, 0, 1, 1, 1 ],
		[ 0, 1, 1, 1, 0, 1, 1, 1, 0 ],
		[ 0, 0, 1, 1, 1, 1, 1, 0, 0 ],
		[ 0, 0, 1, 1, 1, 1, 1, 0, 0 ],
		[ 0, 0, 1, 1, 1, 1, 1, 0, 0 ],
		[ 3, 3, 1, 1, 1, 1, 1, 3, 3 ],
		[ 0, 0, 0, 0, 0, 0, 0, 0, 0 ],
		[ 0, 0, 0, 0, 0, 0, 0, 0, 0 ],
		[ 0, 0, 0, 0, 0, 0, 0, 0, 0 ],
		[ 0, 0, 0, 0, 0, 0, 0, 0, 0 ],
		[ 0, 0, 0, 0, 0, 0, 0, 0, 0 ],
		[ 1, 1, 1, 1, 1, 1, 1, 1, 1 ],
		[ 0, 0, 0, 0, 0, 0, 0, 0, 0 ],
		[ 0, 0, 0, 0, 0, 0, 0, 0, 0 ],
		[ 0, 0, 0, 0, 0, 0, 0, 0, 0 ],
		[ 0, 2, 0, 3, 0, 3, 0, 3, 0 ],
		[ 0, 0, 0, 0, 0, 0, 0, 0, 0 ],
		[ 0, 3, 0, 3, 0, 3, 0, 2, 0 ],
		[ 0, 0, 0, 0, 0, 0, 0, 0, 0 ],
		[ 0, 0, 3, 0, 3, 0, 3, 0, 0 ],
		[ 0, 2, 0, 3, 0, 3, 0, 3, 0 ],
		[ 0, 0, 0, 0, 0, 0, 0, 0, 0 ],
		[ 0, 0, 0, 0, 0, 0, 0, 0, 0 ],
		[ 0, 0, 0, 0, 0, 0, 0, 0, 0 ],
		[ 0, 3, 0, 3, 0, 3, 0, 3, 0 ],
		[ 3, 0, 3, 0, 3, 0, 3, 0, 3 ],
		[ 0, 0, 0, 0, 0, 0, 0, 0, 0 ],
		[ 0, 0, 0, 0, 0, 0, 0, 0, 0 ],
		[ 3, 0, 3, 0, 3, 0, 3, 0, 3 ],
		[ 0, 3, 0, 3, 0, 3, 0, 3, 0 ],
		[ 3, 0, 3, 0, 3, 0, 3, 0, 3 ]

	]

}
